10.o*
o...oo..
......oo
.....oo.
...o.o..
...oo.o.
...o...o
....o...
..o.oo..
o...oo..
..o.....
